BBA in Auto Retailing	G_B_NONENGG
Ph\.D\. Agril\. Chemistry & Soil Science	PF_NONENGG
MTech Chemical Synthesis and Process Technologies	P_M_ENGG
Environmental Biology	SPL_NONENGG
MSc in Engineering Physics	P_M_NONENGG
MSc in Polymer Chemistry	P_M_NONENGG
M\.A\. Business Economics	P_M_NONENGG
L\.L\.M\. International Law	P_M_NONENGG
PhD in Bengali	PF_NONENGG
MPhil Comparative indian Literature	PF_NONENGG
MSc Post - harvest Technology	P_M_NONENGG
M\.B\.A\. Wealth Management	P_MBA_NONENGG
M\.Phil\. in Home Science	PF_NONENGG
Bachelor of Design in Fashion Design	G_B_NONENGG
Ph\.D\. \(Tibetan\)	PF_NONENGG
Ph\.D\. Linguistics	PF_NONENGG
MSc in Agriculture Chemistry & Soil Science	P_M_NONENGG
BSc in Agricultural Biotechnology	G_B_NONENGG
M\.Tech\. \(Sugar Engineering\)	P_M_ENGG
M\.E\. in Internal Combustion Engineering	P_M_ENGG
Master of Engineering in Environment Management	P_M_ENGG
Oils, Oleochemicals and Surfactants Technology	SPL_ENGG
M\.E\. \(Chemical Engineering\)	P_M_ENGG
PhD in Malayalam	PF_NONENGG
B\.E\. Automobile Engineering	G_B_ENGG
B\.E\.	G_B_ENGG
M\.Sc\. \(Bio - textiles\)	P_M_NONENGG
B\.Sc\. \(Agro - Chemical and Pest Control\)	G_B_NONENGG
BFA Bharatnatayam	G_B_NONENGG
B\.A\. in Hons in English Literature	G_B_NONENGG
Master of Technology in Bio Pharmaceutical Technology	P_M_ENGG
M\.Sc\. Actuarial Science	P_M_NONENGG
M\.E\. in Digital Communication & Networking	P_M_ENGG
Corporate Economics	SPL_NONENGG
BA Hons in Journalism	G_B_NONENGG
M\.Tech\. Power Electronics	P_M_ENGG
Ph\.D\. \(Tourism Management\)	PF_NONENGG
M\.Sc\. \(Applied Biology\)	P_M_NONENGG
(?i)(Acharya)(?-i)	P_OrientalLearning
(?i)(Ayurveda Vachaspati)(?-i)	PF_Ayurveda
(?i)(B\.?A\.? (in )?AIH)(?-i)	G_Arts
(?i)(B\.?A\.? (in )?Anthropology)(?-i)	G_Arts
(?i)(B\.?A\.? (in )?Arts)(?-i)	G_Arts
(?i)(B\.?A\.? (in )?Economics)(?-i)	G_Arts
(?i)(B\.?A\.? (in )?English )(?-i)	G_Arts
(?i)(B\.?A\.? (in )?English Literature)(?-i)	G_Arts